111111111
1PCCCCCE1
111111111
