111111111
100P00E01
10001CC01
111111111
