111111111
1PC010C01
1E100C101
111111111
