11111111111111111111
1PC010C001100C000011
1E100C10011000010C11
10000010C00001000001
10011001111C00000001
11111111111111111111
